18
100
HHHHHHHHHHZ HHHHHZ HHHHHHHZ HHHHZ HHHHZ HHHZ HHHHHHHZ HHZ HHHHHHHHHHHHHHHHHHHHHHHHHHHHHHHHHHHHHHHHHH
H       HH  HHHHH  HH   HH  HHHH  HHHH  HHH  HHHHHHH  HH         JHH                               H
H                                                          HH O  HHH                 R             H
H  R                  A                                   HH HHHH HH  HHHHHHHH    HH     HH    H   H
H            R    HH HHH                                HH        HH         HO  AHHO   AHHO   H   H
H                D             D           D                      HHD        HHHHHHHHHHHHHHHHHHH   H
HH  HH  HHHHHHHHHHHHHHHHHHHHHHHHHHHHHHHHHHHHHHHHHHHH  HHHH     HHHHHHHHHHH   H   J D               H
HHJ HH                                             H  H HH        HH         H HHHHHHHHHHHHHHHHHHHHH
HHHHHHHH   HHHHR             D                          HH        HH   R     H H                   H
H      H DD  JHHHHHHHHHHHHHHHHHHHHHHHHHHHHHHHHHHHH      HHHHHH    HH   HHHHHHH H                   H
H      HHHHHHHH            A A                  HH      HH        HH      HHHH H                   H
H                          HHHHHHHH              HHH    HH        HHH     HHHH H                   H
H  HH                              HHHHH                HH      HHHHHA    HHHH H                   H
H R       HHHH                                         HHH     H    HHH   HHHH     M           M  HH
H            H     HH      R                           HHH R              HHHHHH                  HH
H     HHHH   HHH   HHD                  HH          HHHHHH              HHHHHHHH Å@              HHH
H     HA     HH    HHHHHHH   HHH        HHHH   HHHHHHHHHHH   H    D  HHHHHHHHHHHHHH   M   5 M  HHHHH
HHHHHHHHHHHHHHH    HHHHHHH   HHH   HHHHHHHHH   HHHHHHHHHHHHHHH   HHHHHHHHHHHHHHHHHHHHHHHHHHHHHHHHHHH